<Description>
    <RoomsCollection>    
     <Rooms floor="1">
            <Room>105</Room>
            <Room>106</Room>
            <Room>103</Room>
            <Room>109</Room>
            <Room>110</Room>
            <Room>111</Room>
            <Room>107</Room>
            <Room>103</Room>
            <Room>102</Room>
            <Room>107</Room>
            <Room>102</Room>
            <Room>105</Room>
            <Room>113</Room>
            <Room>101</Room>
            <Room>101</Room>
     </Rooms>
</RoomsCollection>
<StairsCollection>
     <Stairs floor="1">
	       <Stair id="0" endfloor="2" endid="" />
               <Stair id="1" endfloor="2" endid="" />
               <Stair id="2" endfloor="2" endid="" />
               <Stair id="3" endfloor="2" endid="" />
               <Stair id="4" endfloor="0" endid="" />
               <Stair id="5" endfloor="0" endid="" />
               <Stair id="6" endfloor="0" endid="" />
               <Stair id="7" endfloor="0" endid="" />
               <Stair id="8" endfloor="0" endid="" />
     </Stairs>
</StairsCollection>
<ElevatorsCollection>
     <Elavators floor="1">
               <Elevator id="0">
               </Elevator>
               <Elevator id="1">
               </Elevator>
     </Elevators>
</ElevatorsCollection>
    <Maps>
        <Map floor="1">
~ - - - - - - - - - - - - - - - - - - - - - - - - - - - - - ~
-                                                           -
-                                                           -
-                                                           -
-                                                           -
-                                                           -
-                                                           -
-                                                           -
-                                                           -
-                                                           -
-                                                           -
-                                                           -
-                                                           -
-                                                           -
-                                                           -
-                                                           -
-                                                           -
-                                                           -
-                                                           -
-                                                           -                         ~ - - - - - - - - - - - ~ - - - - - - - - - - - - - ~
-                                                           -                         -                       -                           -
-                                                           -                         -                       -                           -
-                                                           -                         -                       -                           -
-                                                           -                         -                       -                           -
-                                                           -                         -                       -                           -
-                                                           -                         -                       -                           -
-                                                           -                         -                       -                           -
-                                                           -                         -                       -                           -
-                                                           -                         -                       -                           -
-                                                           -                         -                       -                           -
-                                                           -                         -                       -                           ~ - - - - - - - - - - ~
~ - - - - - - - - - - - - ~ - - - - - - - - - - - - - D - - ~ - - - - - - - - - - - - ~                       ~ - - - - - ~                                     -
-                         -                                 -                         -                       -           -                                     -
-                         S                                 -                         -                       -           -                                     -
-                         -                                 -                         -                       -           -                                     -
-                         -                                 -                         -                       -           -                                     -
-                         S                                 -                         -                       -           -                                     -
-                         -                                 D                         -                       -           -                                     -
~ - - - - - - - - - - - - ~ - - - - - - - - - - - ~         -                         -                       -           -                                     -
-                                                 -         -                         -                       -           -         ~ - - - - ~ - - - - - - - - ~
-                                                 -         -                         -                       -           -         -         -                 -
-                                                 D         -                         -                       -           -         -         S                 -
-                                                 -         ~ - - - - - - - - - - - - ~ - - - D - - - - - - - ~ - - D - - ~ - D - - ~         -                 -
-                                                 -         -                         -                                                       -                 -
-                                                 -         -                         -                                                       S                 -
-                                                 -         -                         -                                                       -                 -
-                                                 -         -                         -             ~ - - - - - - - - - - - - - - - - - - - - ~ - - - - - - - - ~
-                                                 -         -                         -             -                                                           -
-                                                 -         -                         -             -                                                           -
-                                                 -         -                         -             -                                                           -
-                                                 -         ~ - - - - E - - E - - - - ~             -                                                           -
-                                                 -                                   -             D                                                           -
-                                                 D                                   -             -                                                           -
-                                                 -                                   -             -                                                           -
-                                                 -                                   -             -                                                           -
~ - - - - - - - - - - - - - - - - - - - - - - - - ~         ~ - - - - S - - S - - - - ~             -                                                           -
-                                                 -         -                         -             -                                                           -
-                                                 -         -                         -             -                                                           -
-                                                 D         -                         -             -                                                           -
-                                                 -         -                         -             -                                                           -
-                                                 -         -                         -             -                                                           -
-                                                 -         -                         -             -                                                           -
-                                                 -         -                         -             -                                                           -
-                                                 -         -                         -             -                                                           -
-                                                 -         -                         -             -                                                           -
-                                                 -         -                         -             -                                                           -
-                                                 -         -                         -             D                                                           -
-                                                 -         -                         -             -                                                           -
-                                                 -         -                         -             -                                                           -
-                                                 D         -                         -             -                                                           -
-                                                 -         -                         -             -                                                           -
-                                                 -         ~ - - - - - - - - - - - - ~             ~ - - - - - - - - - - - - - - - - - - - - - - - - - - - - - ~
~ - - - - - - - - - - - - - - - - - - - - - - - - ~                                                 -                                                           -
-                                                 -                                                 -                                                           -
-                                                 -                                                 D                                                           -
-                                                 D                                                 -                                                           -
-                                                 -                                                 -                                                           -
-                                                 -                                                 -                                                           -
-                                                 -         ~                                       ~ - - - - - - - - - - - - - - - - - - - - - - - - - - - - - ~
-                                                 -         -                                                                                                   -
-                                                 -         -                                                                                                   -
-                                                 -         -                                                                                                   -
-                                                 -         -                                                                                                   -
-                                                 -         -                                                                                                   -
-                                                 -         -                                                                                                   -
-                                                 -         -                                                                                                   -
-                                                 -         -                                                                                                   -
-                                                 -         -                                                                                                   -
-                                                 D         -                                                                                                   -
-                                                 -         -                                                                                                   -
-                                                 -         -                                                                                                   -
~ - - - - - - - - - - - - - - - - - - - - - - - - ~ - - - - ~ - - - - - - - - - - - - - - - - - - - - - - - - - - - - - - - - - - - - - - - - - - - - - - - - - ~




















~ - - - - - - - - - - - - ~ - - - - - - - - - - - - - - - - - ~
-                         -                                   -
-                         -                                   -
-                         -                                   -
-                         -                                   -
~ - - - - - - ~           -                                   -
-             -           -                                   -
-             ~ - D - - - ~                                   -
-                         -                                   -
-                         -                   ~ - - - - - - - ~
-                         -                   -               -
-           ~ - D ~       ~ - - - ~           S               -
-           -     -       -       -           -               -
-           -     -       D       -           ~ - - - - - - - ~
-           -     -       -       -                           -
~ - - - - - ~ - - ~ ~ - - ~       -                           -
-                   -     -       -                           -
-                   -     -       -                           -
-                   -     -       ~ - - ~       ~ - - - - - - ~
-                   ~ D - ~       -     -       -             -
-                         D       -     -       -             -
-                         -       -     D       D             -
-                         -       -     -       -             -
-                         -       -     -       -             -
-                         -       ~ - - ~       -             -
-                         -             - - D - ~ - - - - - - ~
~ - - - - - - - - - - - - ~             -                     -
-             S           P             -                     -
-             -           -             -                     -
-             S           -             -                     -
-             -           -             -                     -
~ - - - - - - ~ - - - - ~ - - - - - - - ~ - - - - - - - - - - ~
        </Map>
    </Maps>
</Description>