<Description>
    <RoomsCollection>    
     <Rooms floor="0">
            <Room>016</Room>
            <Room>015</Room>
            <Room>017</Room>
            <Room>014</Room>
            <Room>028</Room>
            <Room>029</Room>
            <Room>019</Room>
            <Room>027</Room>
            <Room>012</Room>
            <Room>008</Room>
            <Room>034</Room>
            <Room>010</Room>
            <Room>036</Room>
            <Room>035</Room>
            <Room>032</Room>
            <Room>037</Room>
            <Room>009</Room>
            <Room>033</Room>
            <Room>007</Room>
            <Room>006</Room>
            <Room>004</Room>
            <Room>038</Room>
            <Room>039</Room>
            <Room>040</Room>
            <Room>016</Room>
            <Room>002</Room>
            <Room>003</Room>
            <Room>001</Room>
            <Room>045</Room>
            <Room>044</Room>
            <Room>043</Room>
            <Room>046</Room>
            <Room>050</Room>
            <Room>051</Room>
     </Rooms>
</RoomsCollection>
<StairsCollection>
     <Stairs floor="0">
	       <Stair id="0" endfloor="1" endid="" />
               <Stair id="1" endfloor="-1" endid="0" />
               <Stair id="2" endfloor="1" endid="" />
               <Stair id="3" endfloor="-1" endid="1" />
               <Stair id="4" endfloor="1" endid="" />
               <Stair id="5" endfloor="1" endid="" />
               <Stair id="6" endfloor="1" endid="" />
               <Stair id="7" endfloor="-1" endid="2" />
     </Stairs>
</StairsCollection>
<ElevatorsCollection>
     <Elavators floor="0">
               <Elevator id="0">
               </Elevator>
               <Elevator id="1">
               </Elevator>
     </Elevators>
</ElevatorsCollection>
    <Maps>
        <Map floor="0">
~ - - - - - - - - - - - - ~ - - - - - - - - - - - - - - - - ~
-                         -                                 -
-                         -                                 -
-                         -                                 -
-                         -                                 -
-                         D                                 -
-                         -                                 -
-                         -                                 -
-                         -                                 -
-                         -                                 -
-                         -                                 -
~ - - - - - - - - - - - - ~                                 -
-                         -                                 -
-                         -                                 -
-                         D                                 -
-                         -                                 -
-                         -                                 -
-                         -                                 -
~ - - - - - - - - - - - - ~ - D - ~ - D - - - - - - - - - - ~
-                         -       -                         -                         ~ - - - - - - ~ - - - - - - - ~ - - - - - - - - - - ~
-                         -       -                         -                         -             -              -                      -
-                         D       -                         -                         -             -              -                      -
-                         -       -                         ~ - - P - - - - - - P - - ~             -              -                      -
-                         -       -                         -                         -             -              -                      -
-                         -       -                         -                         -             -              -                      -
~ - - - - - - - - ~ - - - ~       -                         -                         -             -              -                      -
-                 -       -       -                         -                         -             -              -                      -
-                 S       D       ~ - - - - - - - - - - - - ~ - - P - - - - - - P - - ~             -              -                      -
-                 -       -       -                         -                         -             -              -                      -
-                 -       -       -                         -                         -             -              -                      -
-                 S       -       -                         -                         -             -              -                      ~ - - - - - - - - - - ~
-                 -       -       -                         -                         -             -              -                      -                     -
- - - ~ - - - - - ~       -       -                         -                         ~ - - - D - - ~ - - - - D  - ~                      -                     -
-     -           -       -       -                         -                         -                                                   -                     -
-     P           P       -       D                         -                         -                                                   -                     -
-     -           -       -       -                         -                         -                                                   -                     -
~ - - ~ - - - - - ~ - - - ~       -                         -                         -                                                   -                     -
-                         -       ~ - - - - - - - - - - - - ~                         ~ - - - - - - - - - - - - - - - D - - - - - - - - - ~ - D - ~ - - - - - - ~
-                         D                                                                                                                       -             -
-                         -                                                                                                                       -             -
-                         -                                                                                                                       S             -
-                         -                                                                                                                       -             -
-                         -       ~ - - - - - - - - - - - - ~     ~ - - - - - - ~     ~ - - - - D - - - - - - ~ - - - - ~ - - ~           ~       -             -
-                         -       -                         -     -             -     -                       -         -     -           -       S             -
~ - - - - - - - - - - - - ~       -                         -     -             -     -                       -         -     -           -       -             -
-                         -       D                         -     -             -     -                       -         D     -           -       -             -
-                         D       -                         -     ~ - E - - E - ~     -                       ~ - - - - ~     P           ~ - - - ~ - - - - - - ~
-                         -       -                         -                         -                       -         -     -           -                     -
-                         -       -                         -                         ~ - - - - - - - - - - - ~         D     -           -                     -
-                         -       -                         -                         -                       -         -     -           D                     -
-                         -       -                         -                         -                       -         -     -           -                     -
~ - - - - - - - - - - - - ~ - D - ~ - - - - - - - - - - - - ~                         -                       ~ - - - - ~ - - ~           -                     -
-                                 -                         -                         -                       -               -           -                     -
-                                 -                         -                         -                       -               -           -                     -
-                                 -                         -                         -                       -               -           -                     -
-                                 -                         -                         -                       -               -           -                     -
-                                 -                         -                         -                       -               D           ~ - - - - - - - - - - ~
-                                 -                         -                         -                       -               -           -                     -
-                                 -                         P                         -                       ~ - - - ~ - - - ~           D                     -
-                                 -                         -                         -                       -       -       -           -                     -
~ - - - - - - - - - - - - - - D - ~                         -                         -                       -       -       -           -                     -
-                                 -                         -                         -                       -       -       -           -                     -
-                                 -                         -                         -                       -       -       -           -                     -
-                                 -                         -                         -                       -       -       -           -                     -
-                                 -                         -                         -                       -       -       -           -                     -
-                                 -                         -                         -             ~ - - - - ~ - D - ~ - D - ~ - - D - - ~ - - - - - - - - - - ~
-                                 ~ - - - - - ~ - - - - - - ~     ~ - - - ~           -             -                                                           -
-                                             -             -     -       -           -             -                                                           -
-                                             -             -     -       -           -             -                                                           -
~ - - - - - - - - - - - - - - - - - - - - D - ~             -     ~ - S - ~           -             -                                                           -
-                                             -             -                         -             -                                                           -
-                                             -             -                         -             -                                                           -
-                                             -             D                         -             -                                                           -
-                                             -             -                         -             -                                                           -
-                                             -             -                         -             -                                                           -
P                                             -             -                         -             -                                                           -
-                                             -             -                         -             -                                                           -
-                                             -             -                         -             -                                                           -
~ - - - - - - - - - - - - - - - - - - - - P - ~ - - - - - - ~                         ~ - - - - - - ~ - - - - - - - - - - - - - - - - - - - - - - - - - - - - - ~
-                                                           -                                                                                                   -
-                                                           D                                                                                                   -
-                                                           -                                                                                                   -
-                                                           -                                                                                                   -
-                                                           -                                                                                                   -
-                                                           -                                                                                                   -
-                                                           ~ - - P - - - - - - P - - ~                                                                         -
-                                                           -                         -                                                                         -
-                                                           -                         -                                                                         -
-                                                           -                         -                                                                         -
-                                                           -                         -                                                                         -
-                                                           -                         -                                                                         -
~ - - - - - - - - - - - - - - - - - - - - - - - - - - - - - ~ - - P - - - - - - P - - ~ - - - - - - - - - - - - - - - - - - - - - - - - - - - - - - - - - - - - ~




















~ - - - - - - - - ~ - - - - - - - - ~ - - - - - - - - - - - - ~
-                 -                 -                         -
-                 -                 -                         -
-                 -                 -                         -
-                 -                 -                         -
-                 -                 -                         -
-                 -                 -                         -
-                 -                 -                         -
~ - - - - - D - - ~ - - - - - D - - ~ - - D - ~ - - - - - - - ~
-                                             -               -
-                                             S               -
-                                             -               -
~ - - - - - - - - - - - ~               ~ - - ~ - - - ~ - - - ~
-                       -               -             -
-                       -               -             -
-                       -               P             P
-                       -               -             -
-                       -               -             -
-                       -               ~ - - - ~ - - ~ - - - ~
-                       -               -       -             -
-                       D               P       -             -
-                       -               -       D             -
-                       -               -       -             -
-                       -               -       -             -
-                       -               -       -             -
~ - - - - - - ~ - - - - ~ - P - - ~ - - ~ - D - ~ - - - - - - ~
-             -         -         -     -                     -
-             S         P         P     -                     -
-             -         -         -     -                     -
-             S         -         -     -                     -
-             -         -         -     -                     -
~ - - - - - - ~ - - - - ~ - - - - ~     ~ - - - - - - - - - - ~
        </Map>
    </Maps>
</Description>